Humans: 100
RRRRRRRRRRRRRRRRRRRRRRRRRRRRRRRRRRRRRRRRRRRRRRRRRR
R..@.......Z.....................................R
R................................................R
R................................................R
R................................................R
R................................................R
R................................................R
R................................................R
R................................................R
R................................................R
R................................................R
R................................................R
R................................................R
R................................................R
R................................................R
R................................................R
R................................................R
R................................................R
R................................................R
R................................................R
R................................................R
R................................................R
R................................................R
R................................................R
R................................................R
R................................................R
R................................................R
R................................................R
R................................................R
R................................................R
R................................................R
R................................................R
R................................................R
R................................................R
R................................................R
R................................................R
R................................................R
R................................................R
R................................................R
R................................................R
R................................................R
R................................................R
R................................................R
R................................................R
R................................................R
R................................................R
R................................................R
R................................................R
R............................................Z...R
RRRRRRRRRRRRRRRRRRRRRRRRRRRRRRRRRRRRRRRRRRRRRRRRRR
