Humans: 100
RRRRRRRRRRRRRRRRRRRRRRRRRRRRRRRRRRRRRRRRRRRRRRRRRR
R..@.............................................R
R................................................R
R................................................R
R................................................R
R................................................R
R................................................R
R................................................R
R................................................R
R................................................R
R................................................R
R................................................R
R................................................R
R................................................R
R................................................R
R................................................R
R................................................R
R................................................R
R................................................R
R................................................R
R................................................R
R................................................R
R................................................R
R................................................R
R................................................R
R................................................R
R................................................R
R................................................R
R................................................R
R................................................R
R................................................R
R................................................R
R................................................R
R................................................R
R................................................R
R................................................R
R................................................R
R................................................R
R................................................R
R................................................R
R................................................R
R................................................R
R................................................R
R................................................R
R................................................R
R................................................R
R................................................R
R................................................R
R............................................Z...R
RRRRRRRRRRRRRRRRRRRRRRRRRRRRRRRRRRRRRRRRRRRRRRRRRR
